Grenn	male,Night's Watch
Aerys II Targaryen	male,House Targaryen
Tyrion Lannister	male,House Lannister
Tywin Lannister	male,House Lannister
Alliser Thorne	male,House Thorne
Mance Rayder	male,Free Folk
Amory Lorch	male,House Lorch
Oberyn Martell	male,House Martell
Arya Stark	female,House Stark
Anguy	male,Brotherhood without banners
Beric Dondarrion	male,House Dondarrion
Bran Stark	male,House Stark
Cersei Lannister	female,House Lannister
Gendry	male,brotherhood without banners
Gregor Clegane	male,House Clegane
Jaime Lannister	male,House Lannister
Joffrey Baratheon	male,House Lannister,House Baratheon
Jon Snow	male,House Stark
Rickon Stark	male,House Stark
Roose Bolton	male,House Bolton
Balon Greyjoy	male,House Greyjoy
Loras Tyrell	male,House Tyrell
Belwas	male,House Targaryen
Hodor	male,House Stark
Jojen Reed	male,House Reed
Meera Reed	female,House Reed
Nan	female,House Stark
Theon Greyjoy	male,House Greyjoy
Bronn	male,House Stokeworth
Lothar Frey	male,House Frey
Walder Frey	male,House Frey
Catelyn Stark	female,House Tully
Lysa Arryn	female,House Tully
Robb Stark	male,House Stark
Sansa Stark	female,House Stark
Stannis Baratheon	male,House Baratheon
Meryn Trant	male,House Trant
Pycelle	male,House Lannister
Shae	female,No House
Varys	male,No House
Irri	female,House Targaryen
Daenerys Targaryen	female,House Targaryen
Jorah Mormont	male,House Mormont
Missandei	female,House Targaryen
Rakharo	male,House Targaryen
Viserys Targaryen	male,House Targaryen
Cressen	male,No House
Eddard Stark	male,House Stark
Gilly	female,Free Folk
Craster	male,Night's Watch
Qyburn	male,House Lannister
Renly Baratheon	male,House Baratheon
Tommen Baratheon	male,House Lannister,House Baratheon
Janos Slynt	male,Night's Watch
Kevan Lannister	male,House Lannister
Margaery Tyrell	female,House Tyrell
Myrcella Baratheon	female,House Baratheon of King's Landing
Dalla	female,No House
Melisandre	female,R'hllor
Orell	male,Free Folk
Val	female,No House
Ygritte	male,Mance Rayder
Lancel Lannister	male,House Lannister of Casterly Rock
Marillion	male,No House
Styr	male,Thenn
Ellaria Sand	female,House Uller
Mace Tyrell	male,House Tyrell
Chataya	female,Chataya's brothel
Shireen Baratheon	female,House Baratheon of Dragonstone
Doran Martell	male,House Nymeros Martell
Walton	male,House Bolton
Will	male,Night's Watch
Jon Arryn	male,House Arryn
Jory Cassel	male,House Cassel
Syrio Forel	female,House Stark
Rhaego	female,House Targaryen
Mirri Maz Duur	female,Dothraki people
Yoren	female,Night's Watch
Rodrik Cassel	male,House Cassel
Dagmer	male,House Greyjoy
Pyat Pree	female,Undying Ones
Doreah	female,House Targaryen
Xaro Xhoan Daxos	male,Thirteen
Jeor Mormont	male,House Mormont
Rast	male,Night's Watch
Polliver	male,House Clegane
Tansy	female,Peach
Hizdahr zo Loraq	male,House of Loraq,House Targaryen
Areo Hotah	male,House Martell
Trystane Martell	male,House Martell
Euron Greyjoy	male,House Greyjoy
Howland Reed	male,House Reed
Osha	male,House Stark
Lem	male,Brotherhood without banners
Grey Worm	male,Unsullied
Tormund	male,Wildings
Wun Weg Wun Dar Wun	male,Free Folk
Walder Rivers	male,House Frey
Aemon	male,House Blackfyre
Samwell	male,Night's Watch
Robert Stark	male,House Stark
Brynden	male,No House
Sandor	male,No House
Thoros	male,No House
Barristan	male,No House
Illyrio	male,No House
Maester Luwin	male,No House
Brienne of Tarth	female,House Tarth
Podrick	male,No House
Edmure	male,No House
Hoster	male,No House
Jeyne	female,House Westerling
Petyr	male,No House
Roslin	female,House Frey,House Tully
Elia	female,House Martell
Ser Ilyn Payne	male,House Payne
Daario	male,No House
Khal Drogo	male,House Targaryen,Dothraki people
Aegon	male,House Targaryen
Kraznys	male,No House
Rhaegar	male,House Targaryen
Worm	male,No House
Davos	male,House Baratheon
Salladhor	male,House Baratheon
Eddison	male,Night's Watch
Bowen	male,House Forrester
Rattleshirt	male,Free Folk
Jon Arryn	male,House Baelish,House Arryn
Olenna Tyrell	female,House Tyrell
Qhorin	male,Night's Watch
Rickard	male,House Stark
Ramsay Bolton	male,House Bolton
Ned Stark	male,House Stark
Littlefinger	male,No House
Robert Baratheon	male,House Baratheon
Ser Meryn	male,House Baratheon
Stillborn	male,House Targaryen
Ser Amory Lorch	male,House Lannister
Daenerys Targaryens	female,House Targaryen
Karl Tanner	male,Night's Watch
Daenerys	female,House Targaryen
Hound	male,No House
Ros	female,No House
Talisa Stark	female,House Stark
Black Walder Rivers	male,House Frey
Locke	male,House Bolton
Mountain	male,House Lannister
Mag the Mighty	male,Fre Folk
Pyp	male,Night's Watch
Olly	male,Night's Watch
Karsi	female,Wildings
Wights	female,Wildings
Harpy	male,House Lannister
Myranda	female,House Bolton
Theon Grejoy	male,House Greyjoy
Tyene	female,House Martell
Obara	female,House Martell
The Flasher	male,No House
Walda Bolton	female,House Bolton
Ser Arthur Dayne	male,House Dayne
Khal Moro	male,Dothraki people
Lady Crane	female,No House
Waif	female,House of Black and White
Razdal mo Eraz	male,No House
Belicho Paenymion	male,No House
Jon Umber	male,House Umber,House Stark
The High Sparrow	male,No House
Cersei	female,House Lannister
